SRRRWWWRRWWWRWW
WWRWWRRRWWWWRRR
WRRRRWRRWWWWWWR
WWWRRWWRRRWWRRR
RRRRWWWRWWWWRWW
WWRWWWRRWWRRRWW
WRRRWWWRWWWRWWW
WWWRRWWRRWWWWWW
WRRRWWWWRRWWWWW
RRWWWWWWWRRRRWW
RWWWWWWRRRWWRWW
RRRWWWWWWRWWRRW
WWWWWRRWWRRWWRW
RWWWWRWWRRWWWWW
RWWWWRWWEWWWWWW