SRRWRRRWRWRWRWR
RWWWRWRWRWRWRWR
RRRRRWRRRWRRRWR
RWWWWWRWRRRWRWR
RRRWRRRWRWRWRWR
WWRWRWWWRWWWRRR
RRRWRWRWWWRRRWW
RWWWRWRWRWRWRRW
RWRRRWRRRWRWWRW
WWRWRWRWRRRRWRR
RWRWRWRWRWWRWWR
RWWWWWRWRWRRRWR
RRWRRRRWRWWWRWR
WRRRWWWWWWRRRWR
WWWRRGEWRRRWWWW